MX BX BX MX WX WX MX MX
PX PX PX PX WX WX PX PX
PX PX PX PX WX WX PX PX
PX PC BX PX WX WX PX PX
PX PX PFu PX WX WX PX PX
PX PX PX PSd PX PX PX PX
PX MX BX BX PX PX PX MX
MX MX MX BX WX WX MX MX