MX BX MX PX PX PX MX MX
PX PX PX PFd PX PX PX PX
PX PX PX PX PX PX PC PX
MX BX PSl BX PX PX MX MX
MX BX PX BX PX PX MX MX
PX PX PX PX PX PX PX PX
PX PX PX PX PX PX PX PX
MX BX BX MX PX PX MX MX