WX WX WX WX WX WX WX WX
WX PX PX PX PX PX PX PX
PX PX PX BX BX PX PX PX
PX BX PX BX BX PX PX PX
PX PX PX PSu PX PX PX PX
PX BX WX PX PFu PX PX PX
PX PX PX PX BX PX PC PX
PX PX PX PX PX PX PX PX