PX PX PX PX PX PX WX WX
PX PX PX PX PX WX MX MX
PX PX PFr PX PX WX PX BX
PX PX PX PX PX WX MX MX
PX PX PFr PX PX WX PX BX
PX PX PX PX PX WX MX MX
PX PX PX PX PX WX WX MX
PX PX PC PX PX PX WX WX