PX MX PX PX MX MX MX MX
PX PX PX PX BX MX MX MX
PX PX PC PX PX BX MX MX
PX PX PX PFr PX PX BX MX
PX PX PX PX PX PX PX PX
MX BX PX PX PX PX PX PX
MX MX BX PX PX PX PX PX
MX MX MX PX PX MX PX PX