WX MX WX PX PX PX WX MX
WX WX WX PC PX PX WX WX
BX PX PX PX PX PX PX PX
BX BX PX PX PX PFl PX PX
BX PX PX PX PX PX PSd PX
BX PX PX PX PX PX BX PX
WX WX WX PX PX PX WX WX
WX MX WX PX PX PX WX MX