WX WX WX MX WX WX MX PX
PX PX PX PX PX PX PX PX
PX BX PX PX PX PX PX PX
PX BX PX PX PFl PX PX PX
PX PX PX PX PC BX PX PX
BX BX PX PX PX PSu PX PX
PX PX PX PX PX PX BX PX
PX WX PX PX PX PX WX PX