WX WX WX WX WX WX WX WX
WX WX PX PX PX PX PX PX
WX PX PX BX PX PX PX PX
BX PSl PX PX PX PX PX PX
BX PX BX PX BX PX PC PX
WX PFr BX PX BX PX PX MX
WX PX PX PX PX PX PX MX
WX WX PX PX PX MX MX MX