PX PX PX PX PX PX PX WX
PX PX BX PX PX BX PX WX
PX PX PSu PX PX PX PX PX
PX PX PX PX PC PX PX PX
PX PX PX PX PX PX WX PX
PX PX BX PX PFl PX PX PX
PX PX PX PX PX PX WX PX
BX MX BX MX WX WX WX WX