MX MX PX PX PX PX WX PX
BX PX PX PX PX PX WX PX
BX PX PX PX PX PX WX PX
BX PX PX PX PX PX WX PFl
BX PX PC PX PX PX WX PX
BX PX PX PX PX PX WX PX
BX PSl PX PX PX PX WX PX
MX MX PX PX PX PX WX PX